111111111
10C0P0E01
111111111
111111111