111111111111111
100000C00000C01
1000E0000000001
10000C0000P0001
111111111111111