111111111111111
100000C00000C01
1000E00000P0001
10000C000000001
111111111111111