111111111111111
1010100000C0001
1100E0010000001
1C01100100000P1
111111111111111