11111111111111111111111111111111111111111111111111111
10000000000000000000000000000000000000000000000000001
10000000000000000000000000000000000000000000000000001
10000000000000000000000000000000000000000000000000001
10P00000000000000000000000000000000000000000000000001
10000000000000000011110000000000111100000000000000001
10000000000000000011110000000000111100000000000000001
10000000000000000000000000000000000000000000000000001
1000CCCCCCC00000000000000000000000000000000CCCCCCC001
10000000000000000000000000110000000000000000000000001
1000CCCCCCC00000000000000111100000000000000CCCCCCC001
10000000000000000000000000000000000000000000000000001
10000000000000000000000000000000000000000000000000001
10000000000001100000000001111000000000011000000000001
10000000000000110000000011001100000000110000000000001
10000000000000011000000110000110000001100000000000001
10000000000000000111111000000001111110000000000000001
100000000000000000000000000000000000000000000000E0001
10000000000000000000000000000000000000000000000000001
10000000000000000000000000000000000000000000000000001
11111111111111111111111111111111111111111111111111111