111111111
100000001
100CPE001
100000001
111111110