11111111111
1P000E00C01
111111111111