1111111111111
1E000000P00C1
1111111111111