1111111111111
1E00~000P00C1
1111111111111