1111111111111
1E0000P0P0C01
1111111111111