1111111111
10E0000001
1000P00001
1000000001
1111111111
10000C0001
1111111111